%%%%%%%%%%%% %%%%%
 ..... #G...%%%.. 
%.%%%%.%%%.%.%%%.%
%...%..%o%.......%
%.%.%%.%.%.%%%%%.%
%.%....%.%.%.....%
%.%.%%.%.%.%.%%%.%
%.%.%..........%.%
%.P.%%.%%%.%%%.%.%
%%%%%%.........%.%
%%%%%%.%.%.%%%.%.%
%.E.%%.%.%.%%%...%
%.%.%..%.%...%.%.%
%.%.%%.%.%.%.%.%.%
%.%....%%%.%.%.%%%
%.%.%%...........%
%...%%%.%%%%.%.%.%
 .%%%.....o#G%.%. 
%.....%.%%%%.%%%.%
%%%%%%%%%%%% %%%%%