%%% %%%%%%%%%%%%%%%%%
 ...%%%.......%%.... 
%.%.%%%.%%%%%.%%.%%%%
%.........%.........%
%.%%%%%.%.%.%.%%%%%.%
%.%.....%.%.%.....%.%
%.%.%%%.%...%.%%%.%.%
%.....%.%%o%%.%.....%
%.%%%.%.%%%%%.%.%%%%%
%.....%.     .%.....%
%.%%%.%.%%G%%.%.%%%.%
%.%%%...%GGG%...%%%.%
%...%.%.%%%%%.%.%..o%
%.%.%.%.......%.%.%%%
%.%.%.%%%.%.%%%.%.%%%
%.........P.........%
%%%.%.%.%.%.%%%.%.%.%
 o#.%.%.......%.%.%. 
%%%.%%%.%%%%%.%%%.%.%
%.................%.%
%%% %%%%%%%%%%%%%%%%%