%%%%%%%%%%%% %
%%%%%%.......%
%%%%%%.%.%.%%%
%...%%.%.%.%%%
%.%.%..%.%...%
%.%.%%.%.%.%.%
%.%.P..%%%.%.%
%.%.%%.......%
%...%%%.%%%%.%
 .%%%....Go#G 
%.....%.%%%%.%
%.%.%.%......%
%.....%.%%.%%%
%%%%%.%..%.%.%
%...%.%%o%.%.%
%.%.%.%%%%...%
%.%.%.%%...%.%
%.%.E....%.%.%
 .%.%%%.%%.%. 
%.%..%%.%%.%.%
%.%%.%...%.%.%
%......%.....%
%%%%%%%%%%%% %