%%%%%% %%%%%%%%%%%%%%%%%
%....................% %
%.%%.%%%%%%.%%%%%%.%.%%%
%..%.%...........%E....%
%%o%.%.%%.%.%.%%.%.%%%.%
%%%%...%.......%.   P%.%
%%...%.%%.%.%.%%.%#%.%.%
%..%.%...........% %..E%
 .%%.%.%%.%.%.%%.%%%.%. 
%.%%.%.%o......%.%...%.%
%..%.%.%%.%.%.%%.%.%.%.%
%%.................%...%
%%%%%% %%%%%%%%%%%%%%%%%